Time,InitialSiteRow,InitialSiteColumn,SitesChecked,CohortsKilled,MeanSeverity,eco1,eco2,TotalBurnedSites
5,1,18,344,3914,3.9,158,186, 344
5,6,92,600,3813,3.0,0,600, 600
5,18,70,6,56,3.0,0,6, 6
5,23,75,146,934,3.0,0,146, 146
5,29,18,140,2290,4.3,93,47, 140
5,36,6,400,8249,4.9,395,5, 400
5,38,99,72,330,3.0,0,72, 72
5,42,23,27,315,3.3,4,23, 27
5,48,98,10,10,3.0,0,10, 10
5,52,49,303,1428,3.0,0,303, 303
5,53,14,40,933,4.9,40,0, 40
5,53,18,17,221,4.3,11,6, 17
5,56,62,249,353,3.0,0,249, 249
5,60,93,170,450,3.0,0,170, 170
5,69,4,7,37,3.4,7,0, 7
5,69,79,600,3798,3.0,0,600, 600
5,73,58,66,96,3.0,0,66, 66
5,77,41,344,751,3.0,0,344, 344
5,84,81,193,749,3.0,0,193, 193
5,85,54,416,1369,3.0,0,416, 416
5,87,96,234,1963,3.0,0,234, 234
5,90,81,2,2,3.0,0,2, 2
5,92,11,356,3293,3.9,243,113, 356
5,96,67,220,736,3.0,0,220, 220
10,1,2,1,33,5.0,1,0, 1
10,2,3,69,1327,5.0,69,0, 69
10,5,40,62,581,3.0,0,62, 62
10,8,35,1,8,3.0,0,1, 1
10,14,50,284,1714,3.0,0,284, 284
10,16,74,6,23,1.7,0,6, 6
10,22,42,298,2350,3.0,0,298, 298
10,23,31,369,4022,3.8,158,206, 364
10,30,35,1,1,3.0,0,1, 1
10,30,56,14,140,3.0,0,14, 14
10,36,52,20,170,3.0,0,20, 20
10,38,35,19,136,3.0,0,19, 19
10,39,32,350,2832,3.0,7,342, 349
10,46,59,211,631,3.0,0,211, 211
10,52,91,314,1420,2.9,0,314, 314
10,58,52,16,31,2.8,0,16, 16
10,65,27,244,1987,3.1,17,227, 244
10,78,14,2,17,4.5,2,0, 2
15,2,42,1,7,3.0,0,1, 1
15,5,58,165,606,3.0,0,165, 165
15,22,33,3,8,1.7,0,3, 3
15,22,61,136,761,2.9,0,136, 136
15,29,90,71,519,3.0,0,71, 71
15,29,96,110,446,2.4,0,110, 110
15,35,84,57,170,2.9,0,57, 57
15,38,93,1,1,1.0,0,1, 1
15,51,83,2,1,1.0,0,2, 2
15,70,13,1,3,4.0,1,0, 1
15,82,44,7,17,1.3,0,7, 7
15,87,92,6,38,2.3,0,6, 6
20,7,54,1,3,1.0,0,1, 1
20,25,29,6,4,1.0,0,6, 6
20,33,16,1,3,1.0,1,0, 1
20,36,57,31,204,2.9,0,31, 31
20,43,68,61,450,2.9,0,61, 61
20,50,74,35,194,3.0,0,35, 35
20,54,32,13,15,2.1,0,13, 13
20,56,9,61,700,4.1,61,0, 61
20,59,50,9,18,2.1,0,9, 9
20,61,45,1,10,3.0,0,1, 1
20,62,90,3,1,2.0,0,3, 3
20,64,45,190,401,2.6,0,190, 190
20,76,2,15,76,4.5,15,0, 15
20,76,23,273,555,2.7,11,262, 273
20,80,5,151,638,3.5,151,0, 151
20,80,53,2,1,2.0,0,2, 2
20,99,51,3,3,2.3,0,3, 3
25,1,45,81,159,2.5,0,81, 81
25,6,9,1,1,2.0,1,0, 1
25,29,84,3,6,1.0,0,3, 3
25,56,30,6,9,2.2,0,6, 6
25,75,74,260,238,3.0,0,260, 260
25,76,38,19,26,2.6,0,19, 19
25,94,41,14,13,3.0,0,14, 14
30,7,85,5,14,3.0,0,5, 5
30,29,69,208,731,2.9,0,208, 208
30,30,35,13,20,3.0,0,13, 13
30,31,21,2,1,3.0,0,2, 2
30,37,80,4,14,2.5,0,4, 4
30,55,5,6,77,4.7,6,0, 6
30,55,55,2,1,3.0,0,2, 2
30,61,5,120,1147,3.9,120,0, 120
30,68,14,5,25,3.8,5,0, 5
30,72,66,128,94,3.0,0,128, 128
30,73,40,2,2,2.0,0,2, 2
30,81,60,58,75,3.0,0,58, 58
30,88,75,33,5,2.9,0,33, 33
30,89,37,6,12,1.7,0,6, 6
30,90,29,5,11,2.2,0,5, 5
35,8,35,94,112,3.0,0,94, 94
35,9,59,180,280,3.0,0,180, 180
35,32,38,19,32,3.0,0,19, 19
35,32,99,56,87,3.0,0,56, 56
35,39,58,18,20,3.0,0,18, 18
35,40,64,31,46,2.9,0,31, 31
35,41,94,1,2,3.0,0,1, 1
35,43,95,6,5,3.0,0,6, 6
35,44,81,5,5,3.0,0,5, 5
35,48,68,53,76,2.9,0,53, 53
35,53,21,27,191,3.3,4,23, 27
35,57,72,267,301,2.9,0,267, 267
35,60,56,8,4,2.8,0,8, 8
35,68,30,122,182,2.9,11,111, 122
35,69,88,7,2,2.7,0,7, 7
35,70,69,47,44,2.9,0,47, 47
35,86,65,74,5,2.6,0,74, 74
35,97,72,206,236,3.0,0,206, 206
40,3,31,6,1,3.0,0,6, 6
40,4,94,86,61,3.0,0,86, 86
40,5,78,367,383,3.0,0,367, 367
40,66,81,2,2,2.5,0,2, 2
40,68,15,17,117,3.8,17,0, 17
40,69,58,107,80,2.9,0,107, 107
40,76,7,1,2,4.0,1,0, 1
40,84,60,93,109,2.9,0,93, 93
40,97,19,13,26,2.2,11,2, 13
40,97,55,130,125,2.9,0,130, 130
45,2,82,9,8,2.6,0,9, 9
45,5,63,17,27,2.4,0,17, 17
45,20,37,549,552,3.0,0,549, 549
45,24,5,7,37,2.4,7,0, 7
45,30,78,154,179,2.9,0,154, 154
45,32,17,1,1,2.0,1,0, 1
45,36,19,2,32,3.5,2,0, 2
45,48,36,1,1,3.0,0,1, 1
45,52,38,274,360,3.0,0,274, 274
45,53,93,110,26,3.0,0,110, 110
45,70,31,1,1,1.0,0,1, 1
45,79,18,91,146,2.9,14,77, 91
50,1,35,48,50,2.7,0,48, 48
50,2,49,14,22,2.7,0,14, 14
50,8,42,14,13,2.7,0,14, 14
50,13,4,55,357,2.8,55,0, 55
50,37,23,366,801,2.8,92,274, 366
50,40,98,17,7,2.9,0,17, 17
50,63,85,1,1,3.0,0,1, 1
50,69,42,76,36,3.0,0,76, 76
50,76,67,21,21,3.0,0,21, 21
50,83,36,183,201,2.9,0,183, 183
50,84,16,31,81,2.6,31,0, 31
50,89,84,7,2,2.1,0,7, 7
50,92,99,9,13,3.0,0,9, 9
50,94,38,1,1,3.0,0,1, 1
50,97,50,5,9,2.2,0,5, 5
